######################
#°___________________#
#____________________#
#____________________#
#____?__________?____#
#____________________#
#_____??_____________#
#____________________#
######################