######################
#°___________________#
#____________________#
#____________________#
#____________________#
#____________________#
#____________________#
#____________________#
######################