##########
#°_______#
#________#
#___#____#
#___#__?_#
#________#
#_____####
##########